1111111111
1P000000E1
1100000001
1C10000001
1111111111