1111111111
1P100000E1
1100000001
1C00000001
1111111111