1111111111
1P000000E1
1000000001
1C000000011111
1111111111