11111111
11111111
11C00101
11001P11
11000001
11E00001
11111111
11111111